0:100000
1:110000
2:100100
3:100110
4:100010
5:110100
6:110110
7:110010
8:010100
9:010110
10:101000
11:111000
12:101100
13:101110
14:101010
15:111100
16:111110
17:111010
18:011100
19:011110
20:101001
21:111001
22:010111
23:101101
24:101111
25:101011
yup
